**********
XXXX*XXXXX
**********
XXXXXXXX*X
**********
X*XXXXXXXX
**********
X*XXXXXXXX
**********
XXXXXXXX**